111111111111111111111111111111111
100000000000000000000000000000001
101000000000000000000000000000001
100000022222222222222222220000001
100000030000000000000000000330001
100000000000000000000000000000001
100000000000000000000000000000001
100000000000000000000000000000001
100000000000002320000000000000001
100000000000000000000000000000001
100000000000000000000000000000001
100000000000000000000000000000001
100000000000000000000000000000001
100000000000000000000000000000001
100000000000000000000000000000001
100000000000000000000000000000001
111111111111111111111111111111111
