1111111111
1000000001
1001022101
1010000201
1210000101
1000030001
1000000001
1000000001
1000000001
1111111111
