1111111111
1000000001
1121212121
1000000001
1000000001
1000030001
1000000001
1212121211
1000000001
1111111111
