1111111111
1300000221
1000000001
1000000001
1001001001
1022222221
1111111111
