11111111111111111111111111111
10000000000000000000000000001
12121212121212121212121212121
10000000000000000000000000001
12121212121212121212121212121
10000000000000000000000000001
12121212121212121212121212121
10000000000000000000000000001
12121212121212121212121212121
10000000000000000000000000001
12121212121212121212121212121
10000000000000000000000000001
12121212121212121212121212121
10000000000000000000000000001
11111111111111111111111111111